WWPPPPPPPPPPPPE
WWPWWWWWWWWWWWW
WPPWWWPPPPWPPPW
WPWWWWPWWPWPWWW
WPWWWPPWPPWPPPW
WPPPWPPWPWWWWPW
WWWPWWWWPPPPPPW
WWPPPPWWWWWPWWW
WWPWWPWPWWPPPWW
PPPPWPWPPPPWPPW
PWWPPWWPWWWPPPP
PPPWWWPPWPPPWWP
WWPWPPPWWPWWWWP
WWPWWWPWWPWWWWP
SPPPPPPPPPPPPPP
