WWWPPPPWWE
WPPPWWPPPP
PPWWPPWWWW
PWWPPWWWWW
PPPPWPPPWW
WWWPWPWPPP
WPPPWWWWWP
WPWWWPPPWP
WPWPPPWWPP
SPPPWPPPPW
